00000000000000000
01111111111111111
01000000000000001
01000000000000001
01000000000000001
01000000000000001
0100000000000000101
0100000000000000101
010000001100000000
01000000000000001
01000000000000001
01000000000000001
01000000000000001
01000000000000001
01000000000000001
01000000000000001
01111111111111111
